
NO     ./tx/64/walln.xpm

SO  ./tx/64/walls.xpm

WE   ./tx/64/wallw.xpm

EA   ./tx/64/walle.xpm

F   0,120,25

C 75,89,0 

           
           
111111
1000E01
1010001
11 1110 1
1010001
111111
                
            