NO     ./tx/64/space.xpm  

 
 SO  ./tx/64/1.xpm 

WE   ./tx/64/start.xpm

EA ./tx/64/0.xpm

F   220,100,0

C 225,30,0 


  111111111111111
  1000000000110001
  10110000011100001
  10010000000000000111
11111111101000000111001
10000000000010000010001
1110000000000101110101
1100000001010000010001
1000100001111000000001
1001N10001  1000010001
11111111111  1111111111 