NO     ./tx/64/walln.xpm

 
 SO  ./tx/64/walls.xpm

WE   ./tx/64/wallw.xpm

EA ./tx/64/walle.xpm

F   220,100,0

C 225,30,0 


111111111
110011111
110E01111
110011111
111111111
111111111