
NO     ./tx/64/walln.xpm

SO  ./tx/64/walls.xpm

WE   ./tx/64/wallw.xpm

EA   ./tx/64/walle.xpm

F   0,120,25

C 75,89,80

           
           
111111  
100001
101001
11 1E0
111111 
                
            