NO     ./tx/64/space.xpm  

 
 SO  ./tx/64/1.xpm 

WE   ./tx/64/start.xpm

EA ./tx/64/0.xpm

F   220,100,0

C 225,30,0 


111111111
100111111
111E11111
110001111
111111111
111111111
