NO     ./tx/64/walln.xpm

 
 SO  ./tx/64/walls.xpm

WE   ./tx/64/wallw.xpm

EA ./tx/64/walle.xpm

F   220,100,0

C 225,30,0 

11111111111111111              11111111111
100000000000000001             10000000001
1000000111111000001            10000000001
11000001     1000001           11000000011
  100001     1000001             1000001
  100001     1000001             1000001
  10000111111000001              1000001
  1000000000000011               1000001
  10000111111000001              1000001
  100001     1000001             1000001
  100001     1000001             1000001
  100001     1000001             1000001         111111
11000001     100000011  11111  110000001111111111000001
10000001     100000000110000011000000000000000000000001
1N000001     100000000000000000000000000000000000000001
11111111     111111111111111111111111111111111111111111