
NO     ./tx/64/walln.xpm

SO  ./tx/64/walls.xpm

WE   ./tx/64/wallw.xpm

EA   ./tx/64/walle.xpm

F   0,120,25

C 75,89,0 

           
           
111111
1000001
1010001
11 11101
1010W0 1
111111
                
            